xxxxxxxxxx
xx***s r*x
x***x x**x
xxx*    *x
x***   x*x
x***    *x
x*x* x***x
x******xxx
x**x*****x
xxxxxxxxxx