xxxxxxxxxxxxxxxxxxxxxxxxxxxxx
xs     x                  x x
x  xxx x  xxxxxxx  xxxxxxx  x
x  x   x  x     x  x     x  x
x  x   x  x     x  x     x  x
x  x   x  x     x  x     x  x
x  x   x  x     x  x     x  x
x  x   x  x     x  x     x  x
x  x   x  x     x  x     x  x
x  x   x                 x  x
x  x   x  x     x  x     x  x
x  x   x  x     x  x     x  x
x  x   x  x     x  x     x  x
x  x   x  x     x  x     x  x
x  x   x  x     x  x     x  x
x  x   x  x     x  x     x  x
x  x   x  x     x  x     x  x
x  x   x  x     x  x     x  x
x  x   x  x     x  x     x  x
x  x   x  x     x  x     x  x
x  x   x  x     x  x     x  x
x  x   x  x     x  x     x  x
x  x   x  x     x  x     x  x
x  x   x  x     x  x     x  x
x  x   x  x     x  x     x  x
x  x   x  x     x  x     x  x
x  x   x  x     x  x     x  x
x  x   x  x     x  x     x  x
x  x   x  x     x  x     x  x
x  x   x  x     x  x     x  x
x  x      x     x  x     x  x
x  x   x  x     x  x       gx
xxxxxxxxxxxxxxxxxxxxxxxxxxxxx