xxxxxxxxxx
xs       x
x        x
x        x
x        x
x        x
x        x
x        x
x       gx
xxxxxxxxxx